................................................
..         E     ......................  ....  .
.  ........ ....   ....   . ... ....  ..........
.. .........   .... .... .....        ....  ....
.. ....   .... ..  ... ... ....    ......... ...
.       ........    ..     ... ....       ......
..  ....     . ..  .   .   .....   ...  ..... ..
.. . ..    ..  ... ..  .  ..  ...  ..   ....  ..
.  .. .   ...  ..   ....  ..     .. ..  ..    ..
..             ....  ..      . .             ...
.. ..     ....      ..... ..     ........ ......
.. ...... ..... .. .... ....        ...       ..
..   .     ......     .... .  ......  ....... ..
..  ....   ........     ....   ...   ..    .. ..
......    ......  ......      ......... ..    ..
...... .                    .  ......   A  .....
................................................