..............
.E.   .    ...
. . . .    ...
. . .   ..  A.
.   . .  .....
.            .
..............
