................
. ...    .   E .
. ...    . . . .
. .A  ..   . . .
. . ...  . .   .
.              .
................